111111111111111
1P1000000010001
10100111101C1C1
1000C1C00000111
1011111110101C1
1001001E0010101
101101100010001
100001C11110101
111011000000111
100000010011101
1C11111100000C1
111111111111111