111111111
100000001
100001001
10000C101
100011001
1P0001001
10C001011
1000011E1
111111111