11111111
10000001
10001001
1000C101
10P11001
10001001
1C001011
100010E1
11111111